0
-1000
...........................
............*........*.....
............*......*.*.....
........*...*...*....*.....
............*........*.....
...*..*.....*........*.....
...*........*..*.*...*.....
...*........*........*.....
...*...*....*........*.....
...*........*...*..........
...*....*...*..............
...*........*...*..........
...*.*......*......*.......
...*....*...*..............
...*........*..............
...*........*..............
...*........*..............
...*........*..............
............*..............
...........................