0
-1000
...........................
.......*.*.*..*....*...*...
.*.........................
....*.*........*.....*.....
...........................
.*.*.*.*.*.*.*.*.*.*.*.*.*.
*.*.*.*.*.*.*.*.*.*.*.*.*..
...........................
...........................
...........*..*..*....*....
*..*...*.......*..*..*...*.
...........................
*..*....*..*...*...*..*....
...................*.*.*.*.
......................*....
...*...*...*..........*....
...............*..*...*....
..*........................
...........................
...........................
...........................
...........................
..........*..*.....*.......
...*.....*.................
................*.*........
..*.*.*...............*....
.........*.*..*............