0
-1200
...........................
.......******..............
.......**..................
.......******..............
.......**..................
.......******..............
...........................
...........................
.......********............
.......********............
..........**...............
..........**...............
..........**...............
..........**...............
...........................
..........**...............
.........*..*..............
........******.............
.......*......*............
......*........*...........
...........................
...........................
.......*******.............
.......*...................
.......*...................
.......*******.............
.......*...................
.......*...................
.......*...................
..*...........*............
.........*..*....*.........
.*....*........*.*...*.....
...*.......*...............
....*...*.....*....*..*....
...........*.....*.........
...*........*..............
...........................