0
-1000
...........................
...........................
.......&......&......&.....
...................&.......
...&.....&.............&...
...............&...........
..&.................&......
.........&.......&.........
.............&.........&...
.....&...&......&..........
...................&.......
.........&.................
...&..........&...&........
.........&............&....
...........................
.....&........&............
.................&....&....
...........................
..........&................
...........................